1 0 1 1 2 3, 4 0 0 0 2 3, 1 0 1 0 2 3, 1 4 1 0 2 3;
1 1 0 1 2 3, 0 1 0 1 2 3, 1 0 0 1 2 3, 1 0 0 0 2 3;
0 1 0 1 2 3, 0 1 0 1 2 3, 1 0 0 0 2 3, 1 0 0 0 2 3;
0 1 0 1 2 3, 0 1 0 1 2 3, 1 0 0 0 2 3, 1 0 0 0 2 3;
0 0 1 1 2 3, 0 1 1 0 2 3, 1 0 0 0 2 3, 1 0 0 0 2 3;
