-1 6 1 5
1 0 0 1 2 3, 1 0 1 0 2 3, 1 0 1 0 2 3, 1 0 1 0 2 3, 1 0 1 0 2 3, 1 4 1 0 2 3, 1 1 0 4 2 3;
0 1 0 1 2 3, 1 0 0 1 2 3, 1 0 1 0 2 3, 1 1 4 0 2 3, 1 0 0 1 2 3, 1 1 0 0 2 3, 0 1 0 1 2 3;
0 1 0 1 2 3, 0 1 0 1 2 3, 1 1 0 1 2 3, 4 1 0 1 2 3, 0 0 1 1 2 3, 0 1 1 0 2 3, 0 1 0 1 2 3;
0 1 0 1 2 3, 0 1 0 1 2 3, 0 1 0 1 2 3, 0 0 0 1 2 3, 1 0 1 0 2 3, 1 4 1 0 2 3, 0 1 0 4 2 3;
0 1 0 1 2 3, 0 1 0 1 2 3, 0 1 1 1 2 3, 0 1 4 1 2 3, 1 0 0 1 2 3, 1 1 1 0 2 3, 0 1 0 1 2 3;
0 1 0 1 2 3, 0 0 1 1 2 3, 1 0 1 0 2 3, 4 1 1 0 2 3, 0 1 0 1 2 3, 1 1 4 1 2 3, 0 1 0 1 2 3;
0 1 1 1 2 3, 1 0 1 0 2 3, 1 0 1 0 2 3, 1 0 1 0 2 3, 1 0 1 0 2 3, 4 1 1 0 2 3, 0 1 4 1 2 3;
